1 1 1 2 2 3 3
1 4 1 2 2 2 3
1 4 4 2 2 2 2
2 2 2 2 2 2 2
2 2 2 2 6 6 5
7 2 2 2 6 5 5
7 7 2 2 5 5 5

1 1 1 2 2 3 3
1 4 4 2 2 3 5
1 4 2 2 3 3 5 
2 2 2 3 3 6 7
2 3 3 3 3 6 7
3 3 3 6 6 6 7
3 6 6 6 7 7 7

1 1 1 2 2 3 3
1 4 1 5 2 6 3
4 4 1 5 6 6 3
7 4 1 1 1 6 3
7 4 1 1 1 6 3
4 4 4 1 6 6 6
1 1 1 1 1 1 1
