1 2 3 4 5 5 5 5
1 2 3 4 6 7 7 5
1 2 3 4 6 6 7 5
1 2 3 4 4 6 6 5
2 2 3 3 4 4 4 4
2 2 3 3 3 3 3 4
2 2 2 2 2 2 2 2
2 2 2 8 8 8 8 8




1 1 1 2 2 3 3 3
1 4 2 2 2 2 5 3
1 4 4 4 5 5 5 3
1 1 4 6 6 5 7 3
3 1 4 6 6 5 7 3
3 1 8 8 8 8 7 3
3 1 1 7 7 7 7 3
3 3 3 3 3 3 3 3




1 1 1 2 2 3 3 3
1 1 1 1 2 2 2 4
1 5 5 5 6 6 6 4
7 7 5 8 8 6 4 4
7 7 5 8 7 6 4 4
7 7 5 5 7 6 6 4
7 7 7 7 7 7 7 4
7 7 7 7 7 7 7 7